Coat hanger abortions.	None
Man meat.	None
Autocannibalism.	None
Vigorous jazz hands.	None
Flightless birds.	None
Pictures of boobs.	None
Doing the right thing.	None
The violation of our most basic human rights.	None
Viagra®.	None
Self-loathing.	None
Spectacular abs.	None
An honest cop with nothing left to lose.	None
A balanced breakfast.	None
Roofies.	None
Concealing a boner.	None
Glenn Beck convulsively vomiting as a brood of crab spiders hatches in his brain and erupts from his tear ducts.	None
Amputees.	None
The Big Bang.	None
Former President George W. Bush.	None
The Rev. Dr. Martin Luther King, Jr.	None
Smegma.	None
Being marginalized.	None
Cuddling.	None
Laying an egg.	None
The Pope.	None
Aaron Burr.	None
Genital piercings.	None
Fingering.	None
A bleached asshole.	None
Horse meat.	None
Fear itself.	None
Science.	None
Elderly Japanese men.	None
Stranger danger.	None
The terrorists.	None
Praying the gay away.	None
Same-sex ice dancing.	None
Ethnic cleansing.	None
Cheating in the Special Olympics.	None
German dungeon porn.	None
Bingeing and purging.	None
Making a pouty face.	None
William Shatner.	None
Heteronormativity.	None
Nickelback.	None
Tom Cruise.	None
The profoundly handicapped.	None
The placenta.	None
Chainsaws for hands.	None
Arnold Schwarzenegger.	None
An icepick lobotomy.	None
Goblins.	None
Object permanence.	None
Dying.	None
Foreskin.	None
A falcon with a cap on its head.	None
Hormone injections.	None
Flash flooding.	None
Dying of dysentery.	None
Sexy pillow fights.	None
The invisible hand.	None
Jew-fros.	None
A really cool hat.	None
Sean Penn.	None
Heartwarming orphans.	None
Waterboarding.	None
The clitoris.	None
The Three-Fifths compromise.	None
A sad handjob.	None
Men.	None
Historically black colleges.	None
A micropenis.	None
Raptor attacks.	None
Agriculture.	None
A Gypsy curse.	None
Friends who eat all the snacks.	None
Vikings.	None
Pretending to care.	None
The Underground Railroad.	None
My humps.	None
Consultants.	None
Being a dick to children.	None
Geese.	None
A clandestine butt scratch.	None
Bling.	None
Sniffing glue.	None
The South.	None
An Oedipus complex.	None
Eating all of the cookies before the AIDS bake-sale.	None
Sexting.	None
YOU MUST CONSTRUCT ADDITIONAL PYLONS.	None
Mutually-assured destruction.	None
Party poopers.	None
Sunshine and rainbows.	None
Count Chocula.	None
Sharing needles.	None
Being rich.	None
Skeletor.	None
Chivalry.	None
A sausage festival.	None
Michael Jackson.	None
Uppercuts.	None
Emotions.	None
Farting and walking away.	None
Global warming.	None
The Chinese gymnastics team.	None
Necrophilia.	None
College.	None
Spontaneous human combustion.	None
Yeast.	None
Leaving an awkward voicemail.	None
Dick Cheney.	None
White people.	None
Penis envy.	None
Stifling a giggle at the mention of Hutus and Tutsis.	None
Teaching a robot to love.	None
Sperm whales.	None
A drive-by shooting.	None
Scrubbing under the folds.	None
Panda sex.	None
Whipping it out.	None
Catapults.	None
Masturbation.	None
Natural selection.	None
Opposable thumbs.	None
A sassy black woman.	None
Soiling oneself.	None
AIDS.	None
The KKK.	None
Figgy pudding.	None
Seppuku.	None
Gandhi.	None
Preteens.	None
Toni Morrison's vagina.	None
Five-Dollar Footlongs™.	None
Land mines.	None
A sea of troubles.	None
A zesty breakfast burrito.	None
Christopher Walken.	None
Friction.	None
Balls.	None
Dental dams.	None
A can of whoop-ass.	None
A tiny horse.	None
Waiting 'til marriage.	None
Authentic Mexican cuisine.	None
Genghis Khan.	None
Old-people smell.	None
Feeding Rosie O'Donnell.	None
Pixelated bukkake.	None
Re-gifting.	None
Friends with benefits.	None
The token minority.	None
The Tempur-Pedic® Swedish Sleep System™.	None
A thermonuclear detonation.	None
Take-backsies.	None
A moment of silence.	None
The Rapture.	None
Child abuse.	None
A cooler full of organs.	None
Sweet, sweet vengeance.	None
RoboCop.	None
Keanu Reeves.	None
Drinking alone.	None
Oversized lollipops.	None
Giving 110%.	None
Flesh-eating bacteria.	None
The American Dream.	None
Taking off your shirt.	None
Me time.	None
A murder most foul.	None
Nocturnal emissions.	None
The inevitable heat death of the universe.	None
The folly of man.	None
That thing that electrocutes your abs.	None
Cards Against Humanity.	None
Fiery poops.	None
Poor people.	None
Edible underpants.	None
Britney Spears at 55.	None
All-you-can-eat shrimp for $4.99.	None
Pooping back and forth. Forever.	None
Fancy Feast®.	None
Jewish fraternities.	None
Being a motherfucking sorcerer.	None
Pulling out.	None
Picking up girls at the abortion clinic.	None
The homosexual agenda.	None
The Holy Bible.	None
Ronald Reagan.	None
Vehicular manslaughter.	None
Menstruation.	None
Nipple blades.	None
Assless chaps.	None
Full frontal nudity.	None
Hulk Hogan.	None
Daddy issues.	None
The hardworking Mexican.	None
Natalie Portman.	None
Waking up half-naked in a Denny's parking lot.	None
God.	None
Sean Connery.	None
Saxophone solos.	None
Gloryholes.	None
The World of Warcraft.	None
Homeless people.	None
Scalping.	None
Darth Vader.	None
Eating the last known bison.	None
Guys who don't call.	None
Hot Pockets®.	None
A time travel paradox.	None
The milk man.	None
Testicular torsion.	None
Dropping a chandelier on your enemies and riding the rope up.	None
World peace.	None
A salty surprise.	None
Poorly-timed Holocaust jokes.	None
Smallpox blankets.	None
Licking things to claim them as your own.	None
The heart of a child.	None
Seduction.	None
Robert Downey, Jr.	None
Lockjaw.	None
Eugenics.	None
A good sniff.	None
Friendly fire.	None
Keg stands.	None
Intelligent design.	None
The taint; the grundle; the fleshy fun-bridge.	None
Wearing underwear inside-out to avoid doing laundry.	None
Hurricane Katrina.	None
Free samples.	None
Jerking off into a pool of children's tears.	None
A foul mouth.	None
The glass ceiling.	None
Republicans.	None
Explosions.	None
Michelle Obama's arms.	None
Getting really high.	None
Attitude.	None
Sarah Palin.	None
The Übermensch.	None
Pterodactyl eggs.	None
Altar boys.	None
My soul.	None
My sex life.	None
Raping and pillaging.	None
Pedophiles.	None
Forgetting the Alamo.	None
72 virgins.	None
Pabst Blue Ribbon.	None
Domino's™ Oreo™ Dessert Pizza.	None
A snapping turtle biting the tip of your penis.	None
The Blood of Christ.	None
Half-assed foreplay.	None
My collection of high-tech sex toys.	None
A middle-aged man on roller skates.	None
Bitches.	None
Bill Nye the Science Guy.	None
Italians.	None
Her Royal Highness, Queen Elizabeth II.	None
A windmill full of corpses.	None
Adderall™.	None
A stray pube.	None
Prancing.	None
Passing a kidney stone.	None
A brain tumor.	None
Leprosy.	None
Puppies!	None
Bees?	None
Crumpets with the Queen.	None
Frolicking.	None
Team-building exercises.	None
Repression.	None
Road head.	None
A bag of magic beans.	None
An asymmetric boob job.	None
Dead parents.	None
Public ridicule.	None
A mating display.	None
A mime having a stroke.	None
Stephen Hawking talking dirty.	None
Mouth herpes.	None
Overcompensation.	None
Riding off into the sunset.	None
Being on fire.	None
Tangled Slinkys.	None
Civilian casualties.	None
Auschwitz.	None
My genitals.	None
Not reciprocating oral sex.	None
Lactation.	None
Being fabulous.	None
Shaquille O'Neal's acting career.	None
My relationship status.	None
Exchanging pleasantries.	None
Asians who aren't good at math.	None
Alcoholism.	None
Incest.	None
Grave robbing.	None
Hope.	None
8 oz. of sweet Mexican black-tar heroin.	None
Cockfights.	None
Kim Jong-il.	None
Kids with ass cancer.	None
Loose lips.	None
Winking at old people.	None
The Jews.	None
Justin Bieber.	None
Doin' it in the butt.	None
A lifetime of sadness.	None
The Hamburglar.	None
Swooping.	None
Booby-trapping the house to foil burglars.	None
Classist undertones.	None
New Age music.	None
American Gladiators.	None
Not giving a shit about the Third World.	None
The Kool-Aid Man.	None
A hot mess.	None
Tentacle porn.	None
A look-see.	None
Too much hair gel.	None
Lumberjack fantasies.	None
The gays.	None
Scientology.	None
Estrogen.	None
Date rape.	None
GoGurt®.	None
Judge Judy.	None
Dick fingers.	None
Racism.	None
Glenn Beck being harried by a swarm of buzzards.	None
Surprise sex!	None
Police brutality.	None
Passable transvestites.	None
The Virginia Tech Massacre.	None
When you fart and a little bit comes out.	None
Oompa-Loompas.	None
A fetus.	None
Obesity.	None
Tasteful sideboob.	None
Hot people.	None
BATMAN!!!	None
Black people.	None
A gassy antelope.	None
Sexual tension.	None
Third base.	None
Racially-biased SAT questions.	None
Porn stars.	None
A Super Soaker™ full of cat pee.	None
Muhammed (Praise Be Unto Him).	None
Puberty.	None
A disappointing birthday party.	None
An erection that lasts longer than four hours.	None
White privilege.	None
Getting so angry that you pop a boner.	None
The forbidden fruit.	None
Wifely duties.	None
Two midgets shitting into a bucket.	None
Queefing.	None
Wiping her butt.	None
Golden showers.	None
Barack Obama.	None
Nazis.	None
A robust mongoloid.	None
An M. Night Shyamalan plot twist.	None
Getting drunk on mouthwash.	None
Lunchables™.	None
Women in yogurt commercials.	None
John Wilkes Booth.	None
Powerful thighs.	None
Mr. Clean, right behind you.	None
Multiple stab wounds.	None
Cybernetic enhancements.	None
Serfdom.	None
Kanye West.	None
Women's suffrage.	None
Children on leashes.	None
Harry Potter erotica.	None
The Dance of the Sugar Plum Fairy.	None
Lance Armstrong's missing testicle.	None
Dwarf tossing.	None
Mathletes.	None
Parting the Red Sea.	None
The Amish.	None
Dead babies.	None
Child beauty pageants.	None
AXE Body Spray.	None
Centaurs.	None
Copping a feel.	None
Grandma.	None
Famine.	None
The Trail of Tears.	None
The miracle of childbirth.	None
Finger painting.	None
A monkey smoking a cigar.	None
Goats eating coins.	None
Shapeshifters.	1.2
The Care Bear Stare.	1.2
Hot cheese.	1.2
A mopey zoo lion.	1.2
A defective condom.	1.2
Teenage pregnancy.	1.2
A Bop It™.	1.2
Expecting a burp and vomiting on the floor.	1.2
Horrifying laser hair removal accidents.	1.2
Boogers.	1.2
Chutzpah.	1.2
Unfathomable stupidity.	1.2
Breaking out into song and dance.	1.2
Soup that is too hot.	1.2
Charisma.	1.2
Morgan Freeman's voice.	1.2
Getting naked and watching Nickelodeon.	1.2
MechaHitler.	1.2
Flying sex snakes.	1.2
The Make-A-Wish® Foundation.	None
Anal beads.	None
The Force.	None
Kamikaze pilots.	None
Dry heaving.	None
Active listening.	None
Ghosts.	None
The Hustle.	None
Peeing a little bit.	None
A big hoopla about nothing.	None
Glenn Beck catching his scrotum on a curtain hook.	None
Another goddamn vampire movie.	None
The true meaning of Christmas.	1.2
My inner demons.	1.2
Pac-Man uncontrollably guzzling cum.	1.2
My vagina.	1.2
The Donald Trump Seal of Approval™.	1.2
A homoerotic volleyball montage.	1.2
Actually taking candy from a baby.	1.2
Jibber-jabber.	1.2
Crystal meth.	1.2
Exactly what you'd expect.	1.2
Natural male enhancement.	1.2
Passive-aggressive Post-it notes.	1.2
Inappropriate yodeling.	1.2
Lady Gaga.	1.2
The Little Engine That Could.	1.2
Vigilante justice.	1.2
A death ray.	1.2
Poor life choices.	1.2
A gentle caress of the inner thigh.	1.2
Customer service representatives.	1.2
Embryonic stem cells.	1.2
Nicolas Cage.	1.2
Firing a rifle into the air while balls deep in a squealing hog.	1.2
Switching to Geico®.	1.2
Euphoria™ by Calvin Klein.	1.2
The chronic.	1.2
Erectile dysfunction.	1.2
"Tweeting."	1.2
Home video of Oprah sobbing into a Lean Cuisine®.	1.2
