A bucket of fish heads.	1.3
50,000 volts straight to the nipples.	1.3
Being fat and stupid.	1.3
Hospice care.	1.3
A pyramid of severed heads.	1.3
Getting married, having a few kids, buying some stuff, retiring to Florida, and dying.	1.3
A subscription to Men's Fitness.	1.3
Crucifixion.	1.3
A micropig wearing a tiny raincoat and booties.	1.3
Some god-damn peace and quiet.	1.3
Used panties.	1.3
A tribe of warrior women.	1.3
The penny whistle solo from "My Heart Will Go On."	1.3
Funky fresh rhymes.	1.3
The art of seduction.	1.3
The Devil himself.	1.3
Advice from a wise, old black man.	1.3
Destroying the evidence.	1.3
The light of a billion suns.	1.3
Wet dreams.	1.3
Synergistic management solutions.	1.3
Growing a pair.	1.3
Silence.	1.3
An M16 assault rifle.	1.3
Poopy diapers.	1.3
A live studio audience.	1.3
The Great Depression.	1.3
A spastic nerd.	1.3
Rush Limbaugh's soft, shitty body.	1.3
Tickling Sean Hannity, even after he tells you to stop.	1.3
Stalin.	1.3
Brown people.	1.3
Rehab.	1.3
Capturing Newt Gingrich and forcing him to dance in a monkey suit.	1.3
Battlefield amputations.	1.3
An uppercut.	1.3
Shiny objects.	1.3
An ugly face.	1.3
Menstrual rage.	1.3
Roofies.	None
Women in yogurt commercials.	None
A windmill full of corpses.	None
Old-people smell.	None
Being on fire.	None
A micropenis.	None
Sexting.	None
Classist undertones.	None
Not giving a shit about the Third World.	None
The gays.	None
Racism.	None
Free samples.	None
Sexual tension.	None
Figgy pudding.	None
An oversized lollipop.	1.3
Five-Dollar Footlongs™.	None
Barack Obama.	None
Genital piercings.	None
A tiny horse.	None
Elderly Japanese men.	None
A stray pube.	None
The Tempur-Pedic® Swedish Sleep System™.	None
Bingeing and purging.	None
A bag of magic beans.	None
An asymmetric boob job.	None
Famine.	None
African children.	None
Heartwarming orphans.	None
Boogers.	1.2
Men.	None
Dry heaving.	None
My humps.	None
The hardworking Mexican.	None
An Oedipus complex.	None
Darth Vader.	None
Skeletor.	None
Scientology.	None
Estrogen.	None
Penis envy.	None
Pictures of boobs.	None
Pedophiles.	None
Pabst Blue Ribbon.	None
The Pope.	None
Prancing.	None
Repression.	None
Overcompensation.	None
Being fabulous.	None
My relationship status.	None
Eating all of the cookies before the AIDS bake-sale.	None
Dick Cheney.	None
Lance Armstrong's missing testicle.	None
The Amish.	None
Pooping back and forth. Forever.	None
MechaHitler.	1.2
Peeing a little bit.	None
The World of Warcraft.	None
Testicular torsion.	None
A gentle caress of the inner thigh.	1.2
Explosions.	None
Sarah Palin.	None
Amputees.	None
Being marginalized.	None
The Blood of Christ.	None
Bitches.	None
Italians.	None
Dead parents.	None
Dying of dysentery.	None
Sexy pillow fights.	None
Civilian casualties.	None
The female orgasm.	B
Auschwitz.	None
Agriculture.	None
The Boy Scouts of America.	B
Throwing a virgin into a volcano.	B
The Jews.	None
Judge Judy.	None
Surprise sex!	None
The Virginia Tech Massacre.	None
Scrubbing under the folds.	None
An M. Night Shyamalan plot twist.	None
Mr. Clean, right behind you.	None
Cybernetic enhancements.	None
Feeding Rosie O'Donnell.	None
The Trail of Tears.	None
Finger painting.	None
The Care Bear Stare.	1.2
Jewish fraternities.	None
The homosexual agenda.	None
Flying sex snakes.	1.2
Natalie Portman.	None
Another goddamn vampire movie.	None
Hot Pockets®.	None
Robert Downey, Jr.	None
A good sniff.	None
My soul.	None
Fingering.	None
Horse meat.	None
Crippling debt.	None
Praying the gay away.	None
German dungeon porn.	None
Heteronormativity.	None
Dying.	None
One trillion dollars.	B
The invisible hand.	None
A really cool hat.	None
Justin Bieber.	None
YOU MUST CONSTRUCT ADDITIONAL PYLONS.	None
A sausage festival.	None
Michael Jackson.	None
Police brutality.	None
Teaching a robot to love.	None
Catapults.	None
A disappointing birthday party.	None
Balls.	None
Dental dams.	None
Powerful thighs.	None
Serfdom.	None
Children on leashes.	None
Friends with benefits.	None
RoboCop.	None
Copping a feel.	None
Shapeshifters.	1.2
Teenage pregnancy.	1.2
All-you-can-eat shrimp for $4.99.	None
Getting naked and watching Nickelodeon.	1.2
The Holy Bible.	None
Kamikaze pilots.	None
My inner demons.	1.2
Crystal meth.	1.2
Eugenics.	None
The chronic.	1.2
Man meat.	None
The violation of our most basic human rights.	None
Smegma.	None
A bleached asshole.	None
Stranger danger.	None
The terrorists.	None
Same-sex ice dancing.	None
Making a pouty face.	None
Object permanence.	None
The Three-Fifths compromise.	None
Sunshine and rainbows.	None
Emotions.	None
Necrophilia.	None
Panda sex.	None
Whipping it out.	None
The token minority.	None
That thing that electrocutes your abs.	None
Fiery poops.	None
Picking up girls at the abortion clinic.	None
Vehicular manslaughter.	None
Lockjaw.	None
Attitude.	None
A snapping turtle biting the tip of your penis.	None
Public ridicule.	None
Stephen Hawking talking dirty.	None
Tangled Slinkys.	None
Grave robbing.	None
GoGurt®.	None
Passable transvestites.	None
Muhammed (Praise Be Unto Him).	None
Getting so angry that you pop a boner.	None
Multiple stab wounds.	None
The Dance of the Sugar Plum Fairy.	None
A monkey smoking a cigar.	None
Unfathomable stupidity.	1.2
Firing a rifle into the air while balls deep in a squealing hog.	1.2
Self-loathing.	None
Geese.	None
A thermonuclear detonation.	None
The American Dream.	None
God.	None
Hurricane Katrina.	None
A brain tumor.	None
Lactation.	None
Kids with ass cancer.	None
New Age music.	None
Lumberjack fantasies.	None
Puberty.	None
Kanye West.	None
Harry Potter erotica.	None
Dead babies.	None
The true meaning of Christmas.	1.2
Nickelback.	None
The South.	None
Opposable thumbs.	None
Preteens.	None
Land mines.	None
Authentic Mexican cuisine.	None
Sweet, sweet vengeance.	None
Me time.	None
Saxophone solos.	None
Guys who don't call.	None
The taint; the grundle; the fleshy fun-bridge.	None
Winking at old people.	None
Oompa-Loompas.	None
Parting the Red Sea.	None
Ghosts.	None
The Little Engine That Could.	1.2
Vigilante justice.	1.2
Erectile dysfunction.	1.2
Fear itself.	None
William Shatner.	None
A falcon with a cap on its head.	None
Chunks of dead prostitute.	B
Vikings.	None
Farting and walking away.	None
The Chinese gymnastics team.	None
Yeast.	None
Leaving an awkward voicemail.	None
White people.	None
Sperm whales.	None
A sassy black woman.	None
Friction.	None
A can of whoop-ass.	None
A murder most foul.	None
The inevitable heat death of the universe.	None
Being a motherfucking sorcerer.	None
Daddy issues.	None
Gloryholes.	None
A time travel paradox.	None
Poorly-timed Holocaust jokes.	None
Licking things to claim them as your own.	None
Republicans.	None
A mating display.	None
A mime having a stroke.	None
Asians who aren't good at math.	None
Alcoholism.	None
The Kool-Aid Man.	None
Tentacle porn.	None
Lunchables™.	None
AXE Body Spray.	None
Hot cheese.	1.2
A mopey zoo lion.	1.2
A defective condom.	1.2
Actually taking candy from a baby.	1.2
Exactly what you'd expect.	1.2
Inappropriate yodeling.	1.2
Lady Gaga.	1.2
Nicolas Cage.	1.2
The Big Bang.	None
Aaron Burr.	None
Cheating in the Special Olympics.	None
Foreskin.	None
Hormone injections.	None
A sad handjob.	None
Bling.	None
Count Chocula.	None
A sea of troubles.	None
Christopher Walken.	None
Waiting 'til marriage.	None
A cooler full of organs.	None
Giving 110%.	None
Pulling out.	None
Assless chaps.	None
Dropping a chandelier on your enemies and riding the rope up.	None
Wearing underwear inside-out to avoid doing laundry.	None
The glass ceiling.	None
Adderall™.	None
Puppies!	None
Not reciprocating oral sex.	None
Doin' it in the butt.	None
A lifetime of sadness.	None
The Hamburglar.	None
Obesity.	None
Tasteful sideboob.	None
Hot people.	None
Porn stars.	None
Two midgets shitting into a bucket.	None
Nazis.	None
Getting drunk on mouthwash.	None
John Wilkes Booth.	None
The miracle of childbirth.	None
Soup that is too hot.	1.2
The Hustle.	None
A homoerotic volleyball montage.	1.2
Natural male enhancement.	1.2
Switching to Geico®.	1.2
The Rev. Dr. Martin Luther King, Jr.	None
Ethnic cleansing.	None
Extremely tight pants.	B
The Underground Railroad.	None
Natural selection.	None
Taking off your shirt.	None
Waking up half-naked in a Denny's parking lot.	None
Smallpox blankets.	None
Getting really high.	None
My sex life.	None
Hope.	None
A gassy antelope.	None
Third base.	None
A Super Soaker™ full of cat pee.	None
White privilege.	None
Queefing.	None
Golden showers.	None
Breaking out into song and dance.	1.2
Home video of Oprah sobbing into a Lean Cuisine®.	1.2
Autocannibalism.	None
Helplessly giggling at the mention of Hutus and Tutsis.	1.3
Laying an egg.	None
Chainsaws for hands.	None
Arnold Schwarzenegger.	None
An icepick lobotomy.	None
Goblins.	None
Pretending to care.	None
Stormtroopers.	B
Being rich.	None
Seppuku.	None
Toni Morrison's vagina.	None
Pixelated bukkake.	None
The folly of man.	None
Britney Spears at 55.	None
Ronald Reagan.	None
Homeless people.	None
Eating the last known bison.	None
World peace.	None
A salty surprise.	None
72 virgins.	None
Passing a kidney stone.	None
Leprosy.	None
Riding off into the sunset.	None
My genitals.	None
Shaquille O'Neal's acting career.	None
Dick fingers.	None
A fetus.	None
BATMAN!!!	None
Racially-biased SAT questions.	None
Centaurs.	None
Grandma.	None
A Bop It™.	1.2
Horrifying laser hair removal accidents.	1.2
The Make-A-Wish® Foundation.	None
A death ray.	1.2
Embryonic stem cells.	1.2
The profoundly handicapped.	None
The placenta.	None
The clitoris.	None
Sniffing glue.	None
Spontaneous human combustion.	None
The KKK.	None
Flesh-eating bacteria.	None
Poor people.	None
The Übermensch.	None
Altar boys.	None
Black people.	None
Active listening.	None
Pac-Man uncontrollably guzzling cum.	1.2
My vagina.	1.2
Poor life choices.	1.2
Coat hanger abortions.	None
Viagra®.	None
Spectacular abs.	None
A balanced breakfast.	None
Not wearing pants.	1.3
Consensual sex.	1.3
Former President George W. Bush.	None
Cuddling.	None
Science.	None
Tom Cruise.	None
The entire Mormon Tabernacle Choir.	B
Sean Penn.	None
Historically black colleges.	None
Sharing needles.	None
Masturbation.	None
AIDS.	None
Gandhi.	None
A zesty breakfast burrito.	None
Genghis Khan.	None
Take-backsies.	None
Keanu Reeves.	None
Drinking alone.	None
Cards Against Humanity.	None
Edible underpants.	None
Fancy Feast®.	None
Passive-agression.	None
Hulk Hogan.	None
Sean Connery.	None
Scalping.	None
The milk man.	None
The heart of a child.	None
Friendly fire.	None
Jerking off into a pool of children's tears.	None
Domino's™ Oreo™ Dessert Pizza.	None
Half-assed foreplay.	None
My collection of high-tech sex toys.	None
A middle-aged man on roller skates.	None
Bill Nye the Science Guy.	None
Bees?	None
8 oz. of sweet Mexican black-tar heroin.	None
A hot mess.	None
An erection that lasts longer than four hours.	None
Wifely duties.	None
Wiping her butt.	None
Women's suffrage.	None
Child beauty pageants.	None
Expecting a burp and vomiting on the floor.	1.2
Morgan Freeman's voice.	1.2
Anal beads.	None
The Force.	None
Her Majesty, Queen Elizabeth II.	1.3
Vigorous jazz hands.	None
Flightless birds.	None
Doing the right thing.	None
Concealing a boner.	None
A bitch slap.	B
Raptor attacks.	None
Being a dick to children.	None
Mutually-assured destruction.	None
Nipple blades.	None
Full frontal nudity.	None
A foul mouth.	None
Michelle Obama's arms.	None
Frolicking.	None
Mouth herpes.	None
Incest.	None
Swooping.	None
When you fart and a little bit comes out.	None
A robust mongoloid.	None
The Rapture.	None
Road head.	None
Passive-aggressive Post-it notes.	1.2
