Standing next to short people to use them as armrests.	VS
Doctor Who.	VS
EXTERMINATE.	VS
Hookers and blow.	VS
Fuck you, I'm a bear.	VS
THE GODDAMN BATMAN.	VS
Swinging an axe in the air while cornholing a bear.	VS
Just the tip!	VS
SCIENCE!!1!	VS
Bearshark.	VS
A tree.	MLP
Trouser snakes.	VS
The Power of Greyskull.	VS
Drinking on live TV.	VS
Hello Kitty.	VS
Mandatory Sex Party.	VS
Show me your tits!	VS
Tots.	VS
Games you can play with bricks.	VS
Thanking your sex slaves.	VS
Getting drunk before noon.	VS
Googly eyes on a cock.	VS
Clown strippers.	VS
Typing with your genitals.	VS
KERMIT FLAIL.	VS
Pirate hookers.	VS
A giant horse cock.	MLP
Premature ejaculation.	VS
Fancy tampons.	VS
Bounty, the Quicker Picker Upper.	VS
Tinychat.	VS
Moobs.	VS
Lesbians.	MLP
Bleeding Anuses.	VS
A juice box.	MLP
A spoon that is too big.	VS
Boobs.	VS
Not being pregnant.	VS
Dr. Phil.	SG
The sound a single ThunderStix® makes.	SG
The biggest, blackest dick.	SG
A big wet pink laser sword.	NL
A brief moment of aptitude.	NL
John Madden.	NL
Reddit.	NL
Maple syrup.	NL
Olmec.	NL
A mile-long penis.	NL
YouTube.	NL
Indiana Jones.	RS
Hentai.	RS
The Columbine Shooting.	RS
Mr. Hankey the Christmas Poo.	RS
Two midgets stacked up pretending to be one person.	RS
The Bible.	RS
Xyzzy playing around with gender roles.	RS
Four Loko.	RS
Mario brutally murdering Sonic.	RS
Sonic brutally murdering Mario.	RS
The world's tallest midget.	RS
Mr. Fancy Pants.	RS
TotalBiscuit's top hat.	RS
Sex.	NL
Skullcrusher Mountain.	RS
Penn and Teller.	RS
An 8-ball.	RS
Novelty Twitter accounts.	NL
Rule 34.	RS
Laura Croft.	NL
The smallest, whitest dick.	RS
Fruit Fuckers.	RS
A delicious baby.	NL
Beer Pong.	RS
Type-C Tetris music.	NL
A butt egg.	NL
Using hot sauce as lube.	RS
A street cleaning simulator.	NL
Smooth jazz.	RS
South Korea.	NL
Soviet Russia.	RS
Fuck you, I do what I want.	TGWTG
FUCK YOU, I'M SPIDERMAN!	TGWTG
Santa Christ.	TGWTG
Getting mauled by a mountain lion AND a grizzly bear at the same time.	TGWTG
Glenn Beck being torn apart by zombies.	TGWTG
Going full retard.	TGWTG
Ham?	TGWTG
Bees. My God.	TGWTG
Chuck Norris.	TGWTG
My mom.	TGWTG
My penis catching fire.	TGWTG
Bees!	TGWTG
Your mom.	TGWTG
A killer rabbit.	TGWTG
A tiny white dick.	TGWTG
A zombie fisherman.	TGWTG
An awkward slash fic between The Nostalgia Critic and The Angry Video Game Nerd.	TGWTG
An obscure reference only two people will get.	TGWTG
Anal tearing.	TGWTG
Stick figure porn.	TGWTG
The elephant in the room.	TGWTG
The Angry Video Game Nerd.	TGWTG
The Nostalgia Critic.	TGWTG
The Power Glove.	TGWTG
A bird fucking a horse.	TGWTG
A Big Lipped Alligator Moment.	TGWTG
Time travel.	TGWTG
A baseball to the nuts.	TGWTG
Being frozen today.	TGWTG
The League of Legends.	SG
Jumanji.	GFC
Wards.	GFC
K-Pop.	GFC
Doing Gangnam Style at a funeral.	GFC
125% Reccomended Daily Allowance of cock.	GFC
PEEEEEEEEEEEEEEEENIIIISSSSSSSS.	GFC
STEAL ALL THE FARM.	GFC
A 3am phone call.	GFC
Ezreal's hot sugary ass.	GFC
Peanutbutter jelly time.	MrMan
The crushed dreams of a stripper.	MrMan
A molotov cocktail.	MrMan
A Fleshlite™.	MrMan
Granny panties.	MrMan
The Hare Hare Yukai dance.	AN
Genital warts.	MrMan
A skeptical sheriff.	MrMan
A dead hooker.	MrMan
Getting your penis cut in half.	AN
Miss. Piggy.	MrMan
The Fresh Prince of Bel-Air.	MrMan
The town drunk.	MrMan
Morbid obesity.	MrMan
Don Knotts.	MrMan
A MILF.	MrMan
The end of the world.	MrMan
Cousin marriage.	AN
4Kids.	AN
Yellow snow.	MrMan
Realizing, too late, that there is no toilet paper left.	MrMan
Scotch.	MrMan
A fuck-mothering vampire.	AN
Illegal immigrants.	MrMan
Tentacle rape.	AN
FUNimation.	AN
Watching FLCL while tripping on acid.	AN
Sticking your finger up her ass.	AN
A Facebook stalker.	MrMan
Talking like a pirate.	MrMan
Standing outside the gates of the White House completely naked with a revolver in your hand.	AN
Narutards.	AN
Dead catgirls.	AN
Nuns.	MrMan
Bed wetting.	MrMan
Catholic priests who drink, smoke, and carry guns.	AN
Your virgin soul.	AN
Engrish.	AN
Tengen Toppa Gurren Lagann.	AN
A dead meme.	AN
Mewtwo.	AN
Twincest.	AN
Cowboy Bebop.	AN
Fullmetal Alchemist.	AN
Futanari.	AN
Vash the Stampede.	AN
Sarah Fuckin' Palin.	AN
Naruto.	AN
Idiots who don't seem to realize that Avatar: The Last Airbender isn't really an anime.	AN
A fat middle-aged man in a Sailor Moon costume.	AN
Yu-Gi-Oh! The Abridged Series.	AN
OVER 9000!!	AN
Aya Hirano being gang-banged by her entire band.	AN
Drills for hands.	AN
". . . ."	AN
Asian cock.	AN
Holy dildos.	AN
A mindfuck.	AN
A Hello Kitty! vibrator.	AN
Getting off on anime porn.	MrMan
Toilet paper.	MrMan
Laxatives.	MrMan
Mining for nose gold.	MrMan
The Teenage Mutant Ninja Turtles.	MrMan
The Death Note.	AN
Taking a seat with Chris Hansen.	MrMan
Being eaten by a titan.	AN
A big floppy donkey dick.	MrMan
A Cleveland steamer.	MrMan
The Village People.	MrMan
A bag of dicks.	RT
The Card Czar.	DAH
Minecraft.	RT
Reading the manual.	GG
DeviantArt.	Furry
Sonic the Hedgehog.	Furry
StarFox.	Furry
PetSmart.	Furry
A tub of Vaseline.	Furry
Sex with strangers.	Furry
Literally going to Hell.	GG
Mountain Dew	Vidya
Surprise blowjobs.	TGWTG
Space Core.	TGWTG
Duck Hunt	Vidya
DOTA 2.	NL
That one episode of CSI.	Furry
George Costanza	Viyda
the PS4	Vidya
The Wii U	Vidya
the SNES	Vidya
the NES	Vidya
the SEGA Genesis	Vidya
the PSX	Vidya
the duck hunt dog	Vidya
